XXXXXXXXXXXXXXXXXXXX
XX    X       X   XX
XXXXXXXXXXXXXXXXXXXX
         XX         
    XXXXXXXXXXXX    
    XWWWWWWWWWWX
    XWWWWWWWWWWX
    XXXXXXXXXXXX
    X          X
XXXXXXXXXXXXXXXXXXXX
XXXXXXXXXXXXXXXXXXXX
    X          X
    XXXXXXXXXXXX
    XWWWWWWWWWWX
    XWWWWWWWWWWX
    XXXXXXXXXXXX    
         XX         
XXXXXXXXXXXXXXXXXXXX
XX    X       X   XX
XXXXXXXXXXXXXXXXXXXX